0 0 0 0 0 0 0 0 0 0 0 0 0 0 0 0 0 0 0 0 0 0 0 0 0 0 0 0 0 0 
0 0 0 0 0 0 0 0 0 0 0 0 0 0 0 0 0 0 0 0 0 0 0 0 0 0 0 0 0 0 
0 0 0 0 0 0 0 0 0 0 0 0 0 0 0 0 0 0 0 0 0 0 0 0 0 0 0 0 0 0 
0 0 0 0 0 0 1 1 0 0 0 0 0 0 0 0 0 0 1 0 1 0 1 1 0 1 1 1 0 0 
0 0 0 0 1 1 1 1 1 1 1 1 1 1 1 1 1 1 1 1 1 0 0 0 0 0 0 1 1 1 
0 0 1 1 1 1 1 1 1 1 1 1 0 1 1 1 1 1 1 1 1 1 1 1 1 1 1 1 1 1 
0 1 1 0 1 1 1 1 1 1 0 0 1 1 1 1 1 0 0 1 0 1 0 1 4 1 0 0 0 0 
0 0 0 0 0 0 0 6 6 6 6 6 0 0 0 0 0 0 0 0 1 r 0 0 0 4 0 0 0 0 
0 0 0 0 0 0 6 0 0 0 0 0 6 6 6 0 0 0 0 6 4 r 1 0 1 4 0 0 0 0 
0 0 0 0 0 6 6 0 0 0 1 0 1 1 6 1 r r r r r r 1 1 0 1 1 0 0 0 
0 0 0 0 6 6 0 6 6 6 6 1 1 1 1 1 0 0 0 6 6 1 1 0 0 4 0 1 1 1 
0 0 0 6 0 0 6 6 6 6 1 1 1 1 1 6 6 6 6 6 1 1 0 0 1 1 1 1 1 0 
0 0 0 6 6 0 6 6 6 1 1 1 1 1 6 6 0 1 1 1 0 1 1 0 4 0 0 0 0 0 
0 0 0 0 6 6 6 6 1 1 1 5 1 1 6 1 1 1 0 0 0 6 6 0 0 0 0 0 0 0 
0 0 0 0 0 0 6 6 1 1 1 1 1 1 1 1 6 0 0 0 0 6 6 1 0 0 0 0 0 0 
0 0 0 0 0 0 0 1 1 1 6 1 1 1 5 6 6 5 0 0 0 6 0 0 0 0 0 0 0 0 
0 0 0 0 0 0 1 1 1 6 6 1 1 6 6 6 6 6 0 0 6 6 0 0 0 0 2 0 0 0 
0 0 0 3 0 1 1 1 0 0 6 6 0 6 6 6 6 6 6 6 6 0 0 0 0 0 0 0 0 0 
1 1 1 1 1 1 0 0 0 0 0 6 0 1 0 0 0 0 0 0 0 1 0 0 0 0 1 1 1 0 
0 0 0 0 0 0 0 0 0 0 0 6 0 0 0 0 0 0 0 0 0 0 0 0 0 0 0 0 0 0 
