1 1 1 1 1 1 1 1 1 1 1 1 1 1 1 1 1 1 1 1 1 1 1 1 1 1 1 1 1 1 1 1 1 1 1 1 1 1 1 1 
1 0 0 0 0 1 1 1 1 1 1 1 1 1 1 1 1 1 1 1 1 1 1 1 1 1 1 1 0 0 0 0 0 0 1 1 1 1 1 1 
1 0 3 0 0 1 0 0 0 0 0 0 0 0 1 1 1 1 1 1 1 1 1 1 1 1 1 0 0 0 0 0 0 0 0 1 1 1 1 1 
1 0 0 0 0 1 0 4 0 0 0 0 0 0 1 1 1 1 1 1 1 1 1 1 1 1 0 0 0 0 0 0 5 0 0 0 1 1 1 1 
1 1 1 0 0 1 0 0 0 0 0 0 0 0 0 0 0 0 0 0 0 0 0 0 0 0 0 5 0 0 0 0 0 0 0 0 1 1 1 1 
1 1 0 0 0 1 1 1 1 1 0 0 0 0 0 0 0 5 0 0 0 0 0 0 0 0 0 0 0 0 0 0 0 0 0 0 1 1 1 1 
1 1 0 0 0 1 1 1 1 0 0 0 0 0 1 0 0 0 0 0 0 0 0 0 0 0 0 0 0 0 0 0 0 0 4 0 1 1 1 1 
1 1 0 0 0 1 1 1 1 0 0 0 0 1 1 1 1 1 1 1 1 1 1 1 1 1 0 0 4 0 0 0 0 0 0 0 1 1 1 1 
1 0 0 0 0 1 1 1 1 0 0 0 1 1 1 1 1 1 1 1 1 1 1 1 1 1 1 1 1 1 0 0 0 0 0 0 0 1 1 1 
1 0 4 0 0 0 0 0 1 0 0 1 1 1 1 1 1 0 O 0 1 1 1 1 1 0 0 0 1 1 0 0 0 0 0 0 0 0 1 1 
1 0 0 0 0 0 0 0 1 0 0 1 1 1 1 1 1 0 0 0 1 1 1 0 0 0 4 0 1 1 1 1 1 1 1 0 0 0 0 1 
1 0 0 0 0 0 0 0 1 0 0 1 1 1 1 1 0 0 4 0 0 0 0 0 0 0 0 0 1 1 1 1 1 1 0 0 0 0 0 1 
1 0 0 0 0 0 0 0 1 0 0 1 1 1 1 0 0 0 0 0 0 0 0 0 0 0 1 1 1 1 1 1 1 1 0 0 0 0 0 1 
1 1 1 1 1 0 0 0 1 r r 1 1 1 0 0 0 0 0 5 0 0 0 0 0 1 1 1 1 1 0 0 0 0 0 0 0 0 1 1 
1 1 1 0 0 0 0 0 0 0 0 1 1 1 0 0 0 0 0 0 6 0 0 0 0 1 1 1 1 0 0 0 0 0 0 0 1 1 1 1 
1 1 1 0 0 0 0 0 5 0 0 1 1 1 1 0 0 0 0 0 0 0 0 0 0 1 1 1 0 0 0 0 4 0 0 1 1 1 1 1 
1 1 0 0 0 0 4 0 0 0 0 0 0 1 1 0 0 0 0 0 0 0 0 0 0 1 1 1 0 0 0 6 0 0 1 1 0 4 H 1 
1 1 0 0 0 0 0 0 6 0 0 0 0 0 1 1 1 1 0 0 0 1 0 0 0 1 1 1 1 0 0 0 0 0 1 1 0 0 0 1 
1 1 0 0 0 0 0 0 0 0 0 0 0 0 1 1 1 1 1 1 1 1 0 0 0 1 1 1 1 0 0 0 0 0 0 0 0 0 0 1 
1 0 0 0 0 0 0 0 0 0 1 0 0 5 1 1 0 0 0 1 1 0 0 0 0 1 1 1 1 0 0 0 0 0 0 0 0 0 1 1 
1 0 0 0 0 0 0 0 0 0 1 4 0 0 0 0 0 H 0 1 1 0 0 0 0 1 1 1 1 0 0 0 0 1 1 1 1 1 1 1 
1 0 0 0 0 1 1 1 1 1 1 0 0 0 0 0 0 5 0 1 1 0 0 0 0 1 1 1 1 0 0 0 1 1 1 1 1 1 1 1 
1 1 0 0 1 1 1 1 1 1 1 0 B 0 1 1 1 1 1 1 1 0 5 0 0 0 0 0 0 0 0 0 1 1 1 1 1 0 0 1 
1 1 b b 1 1 1 1 1 1 1 1 1 1 1 1 1 1 1 1 1 0 0 0 0 0 0 0 0 0 0 0 1 1 1 0 4 0 0 1 
1 1 0 0 1 1 1 0 0 0 0 5 4 0 0 0 0 0 0 1 1 0 0 0 0 0 0 0 0 0 0 0 0 o 0 0 0 2 0 1 
1 0 0 0 0 0 0 0 0 0 0 0 0 0 0 0 0 0 R 1 1 0 0 0 0 0 0 0 0 0 0 0 0 o 0 5 0 0 0 1 
1 0 0 0 0 0 0 0 0 0 0 0 0 0 0 0 0 0 0 0 1 1 1 1 1 1 1 1 1 1 1 1 1 1 1 0 0 0 0 1 
1 0 0 0 0 0 6 0 0 0 0 0 0 0 0 0 0 0 0 0 0 0 0 H 1 1 1 1 1 1 1 1 1 1 1 0 0 0 0 1 
1 0 0 0 0 0 0 0 0 0 1 1 1 1 1 1 1 1 0 0 0 4 0 5 1 1 1 1 1 1 1 1 1 1 1 0 0 0 0 1 
1 1 1 1 1 1 1 1 1 1 1 1 1 1 1 1 1 1 1 1 1 1 1 1 1 1 1 1 1 1 1 1 1 1 1 1 1 1 1 1 
